RRRC#CR#R
##RC#CRRR
RRR#C##R#
##R#C####
RRRR#####
#####RRRR
RRR###R##
R##..CRRR
RRR..CR#R
##R..CRRR
RRR#C###
####C####
RRRC#CRRR
R#RC##R#R
R#RC##RRR
##RRCRR#R
##B#C#BRR
###CCC###
###C#C###
RRRC#CRRR
R###C###R
RRB#C#B#R
##R###R#R
RRR###RRR
##B###B##